text	label
I would like to send a donation to blue cross	donate
how can i donate	donate
send donation to paris	donate
how do i give money to a ventilator fund	donate
give money to the who fund	donate
how can i donate money to help feed homeless	donate
do you take money	donate
give to the nyc fund	donate
i wish i could do something about this	donate
donate american red cross	donate
I would like to make a donation	donate
i want to donate money to italy	donate
what is the best way to make a donation in my community	donate
please send a donation to a local charity	donate
give money to the local food bank	donate
how can i donate to new york city	donate
donate funds	donate
give out money	donate
who needs money right now	donate
donate doctors without borders	donate
send funds to raleigh	donate
can i donate to my county	donate
donate to make more masks	donate
how can i donate money	donate
I would like to donate	donate
please help me donate to covid 19 medical research	donate
how can i donate to the red cross	donate
I would like to provide funding to spain	donate
coronavirus donation info please	donate
donate to lansing	donate
i want to donate to research in my state	donate
give funding for my area	donate
how do i donate locally	donate
donate for african relief	donate
show me how to donate please	donate
i want to donate to the covid 19 illness people	donate
who is taking coronavirus donations	donate
i would like to help your because	donate
tell me how to donate please	donate
I would like to donate to help italy	donate
i want to fund nyc	donate
donate in my area	donate
send money to the relief fund	donate
donate to the who	donate
make a donation to dallas fundraiser for coronavirus	donate
donate to covid 19 relief now	donate
donate to a local charity	donate
give money to school fund for covid 19	donate
let us donate for new york	donate
please help me send money to nyc hospitals	donate
donate to the food bank	donate
show me organizations accepting donations in my state	donate
covid 19 donations	donate
donate to local schools	donate
I would like to donate to italy	donate
how can i send dollars to someone	donate
how to donate for corona treatment	donate
send funds to nursing homes in my area	donate
i want to send money to unemployed people	donate
donate to covid 19	donate
donate money to who	donate
where can i donate canned goods	donate
how do i donate money	donate
where do i go to donate to the red cross	donate
donate to seattle	donate
charitable donation for covid	donate
can i donate some groceries	donate
donate to the cdc	donate
how can i donate to new york city	donate
whom can i donate to	donate
give to the meals on wheels fund	donate
how can i donate to charity	donate
what are the donation options	donate
donate to the local homeless shelter	donate
how do i donate to the local hospital	donate
provide funding for virus cure	donate
donate to india	donate
good morning dr	hi
hello corona doctor	hi
how are you corona bot	hi
what is new covid doctor	hi
good morning covid bot	hi
hello	hi
bot what is happening	hi
hello doc bot	hi
good morning doctor	hi
doctor corona you there	hi
hey there	hi
morning	hi
hey doc you there	hi
alright bot	hi
how is it going coronabot	hi
how are you covid bot	hi
what are you going to do today dr covid	hi
hey covid bot	hi
how is it going	hi
morning doctor	hi
good morning	hi
how is it going corona doc	hi
hey bot	hi
hi i have a question	hi
how do you do doctor	hi
whassup doc	hi
what is up doc	hi
what is the word covid bot	hi
good evening	hi
hi bot	hi
top of the morning to you covid bot	hi
hi corona bot	hi
hello hello doc	hi
hiya bot doc	hi
whaddup doctor	hi
hello robot	hi
hi doc bot	hi
how is it going	hi
how did you sleep mr covid	hi
hey hey bot doc	hi
good evening	hi
hello bot	hi
hello doc	hi
how is your day going corona doc	hi
hi coronavirus doctor	hi
what is happening	hi
what is up doc	hi
good morning	hi
hey doctor	hi
hello covid bot	hi
hey bot	hi
good morning doctor bot	hi
hey doc	hi
morning corona bot	hi
how are you doing doc	hi
morning corona doc	hi
morning bot	hi
wakey wakey cov bot	hi
nice to meet you	hi
good morning doctor corona	hi
hello	hi
good morning doctor bot	hi
hallo doctor bot	hi
hello doc how is it hanging	hi
how is everything dr covid	hi
gday doc	hi
yo corona bot what is up	hi
could you help me	hi
good day corona doc	hi
how are you doing today	hi
good morning doc	hi
hey doc	hi
how ya goin bot	hi
are you there doctor	hi
hi	hi
hey doc what is new	hi
hi corona	hi
how can i get it	how does corona spread
can the virus spread by skin to skin interaction	how does corona spread
how likely is covid 19 spreadable through tap water	how does corona spread
how likely can you transmit the corona virus	how does corona spread
how is the virus reaching to my house	how does corona spread
what is the main transmission of covid 19	how does corona spread
do gloves actually help decrease the spread of the contact transmission	how does corona spread
can i get the 19 by using public transport	how does corona spread
how can fecal matter be included with covid 19 spreading	how does corona spread
can ticks spread coronavirus	how does corona spread
can the virus be spread by kissing	how does corona spread
may i have more information on airbone transmission	how does corona spread
does the virus float in air	how does corona spread
can people with masks transmit it to other people	how does corona spread
will the 6 feet apart rule really help decrease virus transmission	how does corona spread
are mosquitos and ticks be able to spread corona virus	how does corona spread
can i get infected with covid if someone sneezes on me	how does corona spread
can my snake get covid 19	how does corona spread
does the virus spread slower beacuse of heat	how does corona spread
how is the virus traveling	how does corona spread
can coronavirus be spread in our stool	how does corona spread
can the disease be spread by coughing	how does corona spread
can i get sick with covid through food	how does corona spread
can a ladybug carry the virus	how does corona spread
how likely does covid spread on amazon packages	how does corona spread
can my parrot get the corona	how does corona spread
what are the common vectors	how does corona spread
how does coronavirus infect other people	how does corona spread
is person to person contact the main mode of covid transmission	how does corona spread
can i get covid 19 from kids dirty clothes	how does corona spread
does the virus travel by smells	how does corona spread
how is coronavirus spread in public	how does corona spread
can the virus travel by touch	how does corona spread
how can someone spread the disease	how does corona spread
can the virus travel on clothes	how does corona spread
do flies carry the 19	how does corona spread
can the disease spread from touching your eyes	how does corona spread
can covid 19 spread by shared living spaces	how does corona spread
does covid only infect old people	how does corona spread
should i increase indoor ventilation to prevent covid from spreading	how does corona spread
is covid more likely to spread in humid weather	how does corona spread
how are people being infected with covid 19	how does corona spread
how can the covid 19 spread decrease in a large community	how does corona spread
is covid 19 in the water	how does corona spread
can warm weather slow the spread of covid 19	how does corona spread
how long does the corona stay on my kids toys	how does corona spread
is corona virus spreadable through air filters andor air conditioning	how does corona spread
how do gloves play a part with the covid 19 epidemic	how does corona spread
does corona virus spread through farts	how does corona spread
can i get infected by touch a patient	how does corona spread
can i get it if someone sneezes on me	how does corona spread
can i spread coronavirus if I am pregnant	how does corona spread
can covid 19 spread if you live in high temperature weather	how does corona spread
is corona virus airborne	how does corona spread
is the disease able to spread by food	how does corona spread
how does the virus keep spreading	how does corona spread
why is this virus spreading so fast	how does corona spread
does it travel in the air	how does corona spread
can i get infected with covid through indirect contact	how does corona spread
what precautions can i take to help eliminate spreading of this virus	how does corona spread
does the coronavirus spread through air	how does corona spread
can butterflies carry the virus	how does corona spread
what is causing it to spread	how does corona spread
do fruit flies carry the virus	how does corona spread
how easily is covid 19 spread	how does corona spread
why is the virus spreading	how does corona spread
does corona virus spread from touching someone infected only	how does corona spread
do bees carry the virus	how does corona spread
can asymptomatic people spread coronavirus	how does corona spread
how is the virus traveling	how does corona spread
should i wear a mask	how does corona spread
is it true dogs were less susceptible to the corona	how does corona spread
is coronavirus spread through a certain type of liquid	how does corona spread
can the 19 be spread faster	how does corona spread
can the virus spread though the sewarage system	how does corona spread
can i get covid 19 from insects	how does corona spread
is it true plants can not spread the corona virus	how does corona spread
how many essential workers have been infected so far	latest numbers
how many deaths has covid 19 caused worldwide	latest numbers
how many people are infected daily by corona	latest numbers
what is the rate of recovery for corona in europe	latest numbers
how many people are infected in the bay area	latest numbers
what is the case count in new york	latest numbers
what are the number of cases worldwide	latest numbers
how many people has coronavirus killed	latest numbers
latest stats on recovery in georgia	latest numbers
how many people have been infected	latest numbers
how many hospitals have access to testing for the virus	latest numbers
what is the projected number of deaths from the virus if we do not socially distance	latest numbers
how many new cases are there in california	latest numbers
how many have died in the uk	latest numbers
how many new cases popped up in singapore	latest numbers
what are the statistics on countries enforcing mask wearing versus countries that do not	latest numbers
how many states have flattened the curve	latest numbers
how many people died in california yesterday	latest numbers
number of cases in europe	latest numbers
how many tests are there in are available in the us	latest numbers
how many toddlers have been infected	latest numbers
what are the statistics in canada for covid	latest numbers
how many new cases are there worldwide today	latest numbers
how many corona virus cases are there globally now	latest numbers
tell me the lastest stats in texas	latest numbers
infections because daily by covid	latest numbers
whar are the number of cases in china	latest numbers
how many people have died because of covid	latest numbers
can you give me the latests stats for taiwan	latest numbers
number of cases in vietnam	latest numbers
how many active cases that are mild condition	latest numbers
what ethnicity has taken the largest hit from covid	latest numbers
total deaths from covid in australia	latest numbers
can you tell me the total confirmed cases in the tri state area	latest numbers
what are the statistics for elderly people infected by the virus	latest numbers
how many cases are there in the world	latest numbers
how many children have been affected worldwide	latest numbers
number of cases in north korea	latest numbers
what is the country with the most death count	latest numbers
how many covid19 cases are there now	latest numbers
average age of death from the virus	latest numbers
how many people total in the world have recovered from the virus	latest numbers
what are the newest figures	latest numbers
how many elderly people have recovered from the virus	latest numbers
recovery rate in chicago	latest numbers
what is the average rate of recovery for people between the ages of 20 and 40	latest numbers
what are the latest numbers of south korea	latest numbers
what is the death count in santa clara county	latest numbers
death rate in the united kingdom	latest numbers
what is the latest statistics	latest numbers
average hospital occupancy with cases of corona	latest numbers
number of recovery cases in new york	latest numbers
how many people under the age of 18 are infected	latest numbers
number of recovered cases in italy	latest numbers
what is the stats on corona in new york now	latest numbers
are certain races statistically more likely to get the virus	latest numbers
how many people died yesterday from the covid	latest numbers
how many have recovered in the us	latest numbers
how many people have been tested in the korea so far	latest numbers
what is the average age of people affected in the us	latest numbers
how many people have recovered in china	latest numbers
how many people died yesterday in the yous	latest numbers
show me the lastest stats for china	latest numbers
daily recovery rate in the us	latest numbers
how is it like in california now	latest numbers
total recoveries from covid	latest numbers
death rate of coronavirus in the us	latest numbers
latest stats in the us	latest numbers
what do the pandemic numbers look like	latest numbers
what is the latetest stats on covid19	latest numbers
how many cases are there in india	latest numbers
what are the stats in the uk for the coronavirus	latest numbers
how many confirmed cases are there in new york	latest numbers
how many cases per 100k people in california	latest numbers
what is the death count in south korea	latest numbers
how many people have been found to be infected by the virus	latest numbers
number of people who got tested in new york	latest numbers
does 5g because coronavirus	myths
how can i call the bs	myths
common myths about covid 19	myths
what covid myths have been debunked	myths
coronavirus myths please	myths
what are the newest covid 19 myths	myths
is it true that i can catch covid 19 from animals	myths
is it a myth that coronavirus spreads in cold climates	myths
are the politicians spreading any lies	myths
is it true that i need to wear a mask in public	myths
is it true pets can get covid 19	myths
tell me potential myths about covid	myths
does the vaccine exist in germany	myths
myths about pets and coronavirus	myths
what is the most popular coronavirus myth	myths
coronavirus with heart disease myth	myths
was covid lad made to control masses	myths
what are the myths about covid	myths
top covid myths please	myths
is it a myth that ibuprofin makes coronavirus worse	myths
covid 19 fox news liberal hoax myth	myths
what are the most recent covid 19 myths	myths
why are there lots of myths about coronavirus on the news	myths
is it a myth that gargling salt water kills corona	myths
give me info on the weirdest covid myths	myths
myths about using mask filters	myths
corona myths	myths
did a tiger really get the corona virus	myths
what are the lies they are saying	myths
is it a myth that heat stops coronavirus	myths
covid age myth	myths
is covid fake	myths
what are common myths about corona	myths
is there any truth to the covid myths	myths
is it a myth that 5g gives you covid	myths
does covid live on packages for 24 hours	myths
is it a myth that lysol kills coronavirus	myths
debunked covid19 myths	myths
any misinformation about the virus	myths
myths about face masks to prevent coronavirus	myths
do 5g antennas spread the coronavirus	myths
myths about home remedies for covid 19	myths
is it true that hot baths kill covid 19	myths
did corona virus come from a lab	myths
is it a myth china invented covid	myths
what should i not trust	myths
give me some conspiracy theories on coronavirus	myths
is it a myth that covid is made up	myths
coronavirus myths	myths
why are there so many covid myths	myths
tell me some covid 19 myths that have been debunked	myths
myths about desinfect your shoes every day	myths
did they spread corona on purpose	myths
what are some popular covid myths	myths
is it a myth that covid is worse than the regular flu	myths
gargling salty water to prevent the coronavirus	myths
is it a myth that my dog can give me covid 19	myths
is it a myth that covid 19 started in china	myths
what are the top five myths about coronavirus	myths
tell me information on corona virus myths	myths
is a myth that you can get coronavirus more than once	myths
what news should i not listen to	myths
is covid a hoax	myths
please tell me if it is a myth that soup gives you corona	myths
what are myths about coronavirus	myths
is social distancing a myth	myths
what is the most common myth of covid	myths
myths about covid please	myths
covid myths	myths
pangolin myth covid	myths
is this story true	myths
tell me about common covid myths	myths
fake news	myths
which myths about coronovirus are actually true	myths
any new myths about covid 19	myths
are only older people susceptible to covid	myths
are any of the covid myths true	myths
how is the covid 19 situation near me	news and press
todays coronavirus update please	news and press
will there be a press conference today	news and press
corona updates please	news and press
send me all news articles about coronavirus in california	news and press
anything new about new york	news and press
have there been any updates on coronavirus from the cdc since last week	news and press
updates on covid 19 in the us	news and press
what is the lastest news from italy	news and press
tell me the best news about the covid 19 cure process	news and press
are there any news about coronavirus in my area	news and press
what are the current developments about corona worldwide	news and press
new updates from new york	news and press
coronavirus news subscription	news and press
what is happening with the virus worldwide	news and press
what is the latest covid news	news and press
send me news updates from the last hour	news and press
covid 19 updates	news and press
any news on a vaccine	news and press
what is the most recent news from australia	news and press
news updates corona virus united states	news and press
how is the virus situation in italy now	news and press
what is the news on corona virus in my state	news and press
what are the who press releases on covid 19 this week	news and press
please show me updates about the coronavirus in the us	news and press
can i see todays news on covid 19	news and press
what is the latest updates from the white house	news and press
can i see the latest news about coronavirus	news and press
what is the highest report of covid 19 contagious	news and press
any updates on the corona situation today	news and press
news	news and press
send me an update about trumps corona press briefing	news and press
what time will the press release be today	news and press
send me the latest news from germany please	news and press
current developments fromthe who	news and press
can i see reports on infection rates	news and press
where can i get news on covid 19	news and press
please send me the latest coronavirus news	news and press
what is the most recent news about covid 19	news and press
any news on coronavirus from today	news and press
what was in the last press release about covid	news and press
updates from italy	news and press
corona virus news from bbc	news and press
any news today for rome	news and press
show me yesterdays press release from trump	news and press
coronavirus news please	news and press
any updates from new york	news and press
please send me the latest updates on covid	news and press
latest coronavirus news	news and press
recent developments in my city	news and press
any news about covid	news and press
what did cuomo do regarding covid today	news and press
headlines for corona virus please	news and press
corona virus news updates spain	news and press
what is new with coronavirus in florida	news and press
please give me the latest updates on covid 19	news and press
show me the latest about covid 19 in mexico	news and press
are there any economic updates	news and press
what is the latest on the pandemic in puerto rico	news and press
did anything big happen today	news and press
any updates	news and press
what has who said about covid19	news and press
covid 19 news from south korea	news and press
any news about stay at home orders regarding covid 19	news and press
coronavirus news in spain today	news and press
tell me the latest corona news for europe	news and press
covid updates from the latest press release	news and press
can i get the latest updates for covid in az	news and press
what does the cft about the economic crisis	news and press
what are the most important updates on coronavirus in the world	news and press
what new happened today	news and press
latest corona press release	news and press
most recent news from south korea	news and press
get me todays press release about the virus	news and press
get me news from my hometown	news and press
what is the most recent news from seattle	news and press
covid 19 press releases	news and press
rightio thank you covid doc	okay thanks
thanks a bunch bot doc	okay thanks
thanks for the details	okay thanks
really appreciate this doctor	okay thanks
thanks for the info doc	okay thanks
thanks for the info	okay thanks
thank you doc for teaching about face masks	okay thanks
you are literally a life saver thanks doc	okay thanks
i want to thank you for your help	okay thanks
ok thanks a lot	okay thanks
you are such a big help doc	okay thanks
thanks covid bot	okay thanks
thanks for your help	okay thanks
thank you very much corona doc	okay thanks
may god bless you	okay thanks
thank you very much	okay thanks
great help thanks bot	okay thanks
i just learned about covid 19 symptoms thanks a bunch doc	okay thanks
thanks for everything	okay thanks
great thanks a bunch	okay thanks
thanks for the info doc	okay thanks
i appreciate it doc	okay thanks
thanks for letting me know about high risk areas	okay thanks
grateful for the feedback covid doc	okay thanks
thanks so much corona doc	okay thanks
i appreciate the info doc	okay thanks
thanks for the help doc	okay thanks
i appreciate it thank you	okay thanks
thank you for your interest	okay thanks
you are so useful	okay thanks
got it thanks bot	okay thanks
so grateful for your help	okay thanks
I am so pleassed to learn from you coronabot	okay thanks
got it thank you doctor	okay thanks
thanks for sharing this with me	okay thanks
great info thanks doctor bot	okay thanks
much appreciated bot	okay thanks
thank you for sharing this info with me	okay thanks
thanks for all this covid bot	okay thanks
i appreciate it	okay thanks
thank you for your help corona bot	okay thanks
thanks bot	okay thanks
thanks you rock	okay thanks
much appreciated corona bot	okay thanks
thank you for all your help	okay thanks
thanks for all your help	okay thanks
thanks for the info	okay thanks
much thankful coronabot	okay thanks
i appreciate your help with travel safety tips	okay thanks
thanks for all the info	okay thanks
this is amazing	okay thanks
thanks for the help	okay thanks
thank you so much for all the help	okay thanks
I will be so gratefull to you mr covid	okay thanks
thanks so much bot	okay thanks
thanks doc	okay thanks
thank you for all the information	okay thanks
thanks for your help	okay thanks
thanks for the help	okay thanks
thanks a ton	okay thanks
that is exactly what i needed to know   thanks bot	okay thanks
thanks a million doctor	okay thanks
i appreciate your help dear corona	okay thanks
okay thanks	okay thanks
thanks i appreciate it	okay thanks
thanks much doc bot	okay thanks
thanks for doing this	okay thanks
thank you so much for the info	okay thanks
thank you for your help	okay thanks
gratitude corona doc	okay thanks
thank you for your assistance	okay thanks
alright thanks	okay thanks
thnx bro	okay thanks
got it thanks	okay thanks
okay thank you so much coronabot	okay thanks
thank you for the help today	okay thanks
ty	okay thanks
what will help me stay safe	protect yourself
in what ways can i protect my children	protect yourself
how do i keep safe from getting virus	protect yourself
tell me some ways to avoid coronavirus	protect yourself
how can i protect my dog	protect yourself
how can i protect my kids	protect yourself
what kind of face mask helps	protect yourself
how can i stay safe from covid 19	protect yourself
does staying away 6 feet in public reduce prevention	protect yourself
how effective is hand sanitizer	protect yourself
should i be wiping down my groceries	protect yourself
ways to assure i do not get the virus	protect yourself
tell me some tips to staying safe	protect yourself
what gloves are best for protection	protect yourself
how to avoid getting the virus	protect yourself
do any medications protect against the virus	protect yourself
should i wear face masks to prevent covid 19	protect yourself
should i wear gloves when grocery shopping	protect yourself
should i be ordering packages online	protect yourself
do face masks help	protect yourself
how do i prevent my kids from getting the virus	protect yourself
i do not want to die	protect yourself
what cleaning products should i use	protect yourself
in what ways can we protect ourselves from coronavirus	protect yourself
best place to avoid getting the virus	protect yourself
do i need to wear a face mask to walk outdoors	protect yourself
does standing 6ft apart from others help	protect yourself
what kind of hand sanitizer should i use	protect yourself
do cloth face mask help prevent the spread	protect yourself
do pets need protection if going outdoors	protect yourself
how can i protect against the virus	protect yourself
how can i protect my parents against covid 19	protect yourself
should i disinfect my grocery bags	protect yourself
should i wash my hands with hot or cold water	protect yourself
what are some steps to avoid covid 19	protect yourself
how can i protect my grandparents	protect yourself
does wearing gloves help me stay safe from covid 19	protect yourself
should i take vitamins to protect myself	protect yourself
what should i do if i order take out or delivery food	protect yourself
should i sanitize my clothing after going outside	protect yourself
what should i do to prevent	protect yourself
what are some methods to protecting a newborn baby from covid 19	protect yourself
what measures should elderly individuals be taking	protect yourself
best way to prevent getting the virus	protect yourself
what precautions should i take for covid	protect yourself
will cotton facemasks protect me	protect yourself
top precautions for the virus	protect yourself
should i avoid large crowded places	protect yourself
what are some ways to staying safe from covid 19	protect yourself
how far apart should i stand from other people	protect yourself
can i reuse my face mask	protect yourself
should i wipe down my trunk after going grocery shopping	protect yourself
how can i not get coronavirus	protect yourself
should i stop using cash	protect yourself
how do i not get sick from coronavirus	protect yourself
does regular flu vaccine help fight the virus	protect yourself
ways to protect myself from the virus	protect yourself
how to kill the spread of corona virus on surfaces	protect yourself
how long is the virus alive on surfaces	protect yourself
do kids need to wear face masks	protect yourself
should i sanitize my hands after grocery shopping	protect yourself
what methods will help prevent coronavirus	protect yourself
do face masks help stop coronavirus	protect yourself
does washing hands help	protect yourself
preventive measures	protect yourself
what can i do to protect others from getting the virus	protect yourself
will gloves help stop coronavirus	protect yourself
how can i protect my family	protect yourself
how many times a day should i wash my hands	protect yourself
does drinking water reduce getting the virus	protect yourself
should i need to wash my fresh groceries	protect yourself
are face masks effective	protect yourself
my parents are old what do i do	protect yourself
should i wear gloves outside to prevent coronavirus	protect yourself
how can i protect myself from coronavirus	protect yourself
what can i do to avoid getting sick	protect yourself
how can i protect myself from coronavirus	protect yourself
share the article	share
i want to share this on instagram	share
share this info over text	share
share this on my story	share
share bot to my feed	share
share this chat with my friends	share
shareable link	share
please share this on my page	share
share this bot	share
could i share this on my facebook	share
how do i share link this to my contact list	share
please share this link on my twitter	share
share this article	share
share the chat with my friends	share
share this please	share
post this bot	share
i want to share this info	share
how do i share this	share
share link	share
can i share this link	share
share link with friends on facebook	share
share the chat service please	share
share link	share
send out this information	share
share this link with my friends only	share
share this bot on twitter	share
how do i share this device	share
send this info to my friends	share
can i share this link	share
how can i share this service	share
go on and forward this feature	share
share a link to this	share
can you share this bot	share
share this bot please	share
share the link for this	share
share info about this service	share
share on my social media	share
can you share this please	share
share this with my friends please	share
share chat	share
share this link with my contacts	share
can i share this on my website	share
i want to share this news link	share
please send a link for this service	share
share this story	share
broadcast this chat	share
post to friends	share
share this service with all my followers	share
send link to sister	share
share this info	share
share this article on my facebook feed	share
how do i tell everyone about this	share
share this link to non believers	share
share this with a facebook group	share
I would like to share this	share
how do i share this with reddit	share
share this link	share
post this on my timeline	share
i want to share this on my page	share
share this link to my twitter followers	share
how do i share this link	share
please share this service	share
how do i share this with my family	share
share this service	share
i want to share this service	share
share service please	share
this report is so good to publish	share
share this to friends	share
how can i share you with people	share
share this post now	share
link this publication to my office	share
show me how to share this to my family	share
I will tell my family about this	share
send this to everyone	share
forward this bot	share
show me how i can share this please	share
share the world health bot	share
should i keep my summer trips planned	travel
can i visit my parents in california right now	travel
should i wear a mask and gloves on the subway	travel
what is non essential travel	travel
is it safe to go hiking	travel
what are the safety measures for a domestic travel	travel
is it safe to travel now	travel
are flights safe to take right now	travel
do i have to cancel my trip to italy	travel
where can i go in the world that is safe	travel
can i travel to europe right now	travel
will i be ok if i fly to new york in the summer	travel
what is considered essential travel	travel
is it safe to travel with kids	travel
do i need to disinfect my luggage when travelling	travel
is it safe to travel right now	travel
advice for traveling by train	travel
what is the safest transport right now	travel
can i take the subway to the store	travel
how do i travel safely	travel
can i travel outside the united states	travel
is it safe to travel by your own car	travel
can i travel out of my city	travel
are there any safe destinations	travel
can i fly to see my son across the country	travel
can i get through the border to mexico	travel
is it safe to travel by bus	travel
can i travel to go hiking	travel
i want to know if i can still go to hawaii	travel
travel tips during the pandemic	travel
is it safe to ride a bike	travel
can i travel domestically	travel
should i cancel my vacation	travel
is air travel safe right now	travel
i want to know if i can take a trip to the mountains	travel
what are the best precautions while travelling	travel
how long with travel bans be in effect	travel
is it recommended to stop traveling in the united states	travel
can i go to ny after the quarantine	travel
can i still travel by train	travel
can i visit greece within the next year and be okay	travel
can i travel to mexico via foot	travel
what does the cdc recommend for travelers	travel
need travel advice	travel
do i need to cancel my vacation to japan	travel
when will travel bans lift	travel
should i travel by car	travel
what is essential travel	travel
is there any airline operating these days	travel
is it safer to travel on plane or train	travel
is my trip to las vegas considered non essential	travel
do i need to wear a mask on my subway ride	travel
are airport bus services canceled	travel
what are the current bans on travel in the us	travel
should i cancel all my upcoming flights to the usa	travel
can i take a two hour trip to visit my grandmother	travel
can we move around freely now	travel
what are the least safe places to travel right now	travel
can i drive across state lines	travel
is driving to the store considered essential	travel
can i travel from the us right now	travel
can i travel to go camping	travel
is it safe to get on a flight	travel
advice for traveling in dc	travel
are domestic flights cancelled too	travel
is it safe to travel out of the country	travel
can i take uber	travel
is it safe to drive to cleveland	travel
can i travel to canada right now	travel
can i visit china now	travel
travel agents during quarantine	travel
tell me about travel in the midwest usa	travel
is buying groceries an excuse to be outside	travel
is it safe to go abroad this fall	travel
does cruising count as non essential travel	travel
should i cancel my flight	travel
safe travel options	travel
what main symptoms are clear signs of the disease	what are symptoms
is shortness of breath a symptom	what are symptoms
how can i tell the difference between having allergies or coronavirus	what are symptoms
is diarrhea a symptom	what are symptoms
am i coming down with a cold or covid 19	what are symptoms
if i show symptoms what should i do	what are symptoms
what are some signs of corona virus	what are symptoms
i think i have the flu	what are symptoms
is coughing blood a symptom of it	what are symptoms
can corona virus because a headache	what are symptoms
is having a lack of appetite a symptom of the disease	what are symptoms
how can i tell if someone has corona	what are symptoms
what is the protocol if i show symptoms	what are symptoms
is chest pain a sign i have covid 19	what are symptoms
what symptom is the easiest to notice when someone has the disease	what are symptoms
I have been sneezing a lot is that caused buy the corona	what are symptoms
are aches and pains a symptom of the corona	what are symptoms
how will i know if i have covid 19	what are symptoms
what are some of the symptoms associated with corona virus	what are symptoms
i have a sore throat is this a symptom of the covid 19	what are symptoms
what are the main symptoms of the corona virus	what are symptoms
tell me all of the symptoms of covid19	what are symptoms
what are the main ways to see if i have it	what are symptoms
i have a dry cough does that mean i have the corona virus	what are symptoms
is an upset stomach a sign of covid19	what are symptoms
tell me all the possible symptoms of covid 19	what are symptoms
what should i check to see if i have the disease	what are symptoms
is muscle soreness a corona virus symptom	what are symptoms
my throat is sore do i have the virus	what are symptoms
how can i tell if someone has corona virus	what are symptoms
how to determine if i have corona virus	what are symptoms
should i worry if i have a runny nose	what are symptoms
is headache a symptom of the coronavirus disease	what are symptoms
how can i rid of my cough	what are symptoms
are the symptoms similar to having flu	what are symptoms
what are possible danger signs for it	what are symptoms
if i have a sore throat does that mean i have the corona	what are symptoms
what are the signs you may have the corona	what are symptoms
any new informations for covid 19 symptoms	what are symptoms
if i show symptoms what should i do	what are symptoms
is headache a symptom of the coronavirus disease	what are symptoms
how long does these symptoms last	what are symptoms
i do not have a fever but a headache	what are symptoms
how to tell if a family member has corona virus	what are symptoms
does the covid 19 because diarrhoea	what are symptoms
is coughing a symptom of the corona virus disease	what are symptoms
is vomiting a symptom	what are symptoms
should i go to the hospital if i show symptoms	what are symptoms
what are some early symptoms	what are symptoms
does coughing up phlem mean i have the corona	what are symptoms
is coughing a symptom	what are symptoms
what symptoms should i worry about most	what are symptoms
can corona virus because pnumonia	what are symptoms
what are some tell tale signs of covid 19	what are symptoms
what should i be looking out for to tell if someone has it	what are symptoms
how many different symptoms are there	what are symptoms
should i self isolate if i show symptoms	what are symptoms
what are the symptoms of covid 19	what are symptoms
how do i tell if someone is infected	what are symptoms
is a headache one of the symptoms	what are symptoms
is a runny nose a symptom of the covid 19	what are symptoms
what are the symptoms	what are symptoms
i have been extra tired lately does that mean you have the corona	what are symptoms
is the cough of corona virus contagious	what are symptoms
can you please tell me the symptoms of coronavirus	what are symptoms
can you get a fever from this virus	what are symptoms
how long should i wait to get help if i show signs of corona	what are symptoms
does the covid 19 because nasal congestion	what are symptoms
are the symptoms of covid 19 similar to allergies	what are symptoms
please tell me the symptoms of corona virus	what are symptoms
is covid 19 causing my shortness of breath	what are symptoms
what are the early stage symptoms	what are symptoms
differences between allergies and covid19	what are symptoms
is a fever a symptom of corona virus	what are symptoms
does the corona because lack of appetite	what are symptoms
i have a fever does that mean i have the corona	what are symptoms
do i have allergies or covid 19	what are symptoms
are there any natural treatments for the coronavirus	what are treatment options
is there a vaccine against coronavirus	what are treatment options
where is a covid 19 vaccine being developed	what are treatment options
can i get a vaccine for covid	what are treatment options
is there otc medicine that will help covid	what are treatment options
is vitamin c useful to prevent coronavirus infection	what are treatment options
outline the current covid 19 treatments please	what are treatment options
how do people get rid of the coronavirus	what are treatment options
what medicines are effective against covid 19	what are treatment options
what are the treatment options for covid 19	what are treatment options
does hydroxycholroquine work as a treatment for the coronavirus	what are treatment options
what can i use at home to treat myself if i have corona	what are treatment options
show me treatment options for the virus	what are treatment options
what medicine should i take if i get covid 19	what are treatment options
what can i do first if i get covid 19	what are treatment options
cure for covid 19	what are treatment options
where can i get the covid vaccine	what are treatment options
is there any vaccine for covid 19	what are treatment options
flu treatment options viable to fight corona	what are treatment options
what are the treatment options	what are treatment options
what treatment is there for covid	what are treatment options
what can the hospitals do in this situation	what are treatment options
is coronavirus treatable	what are treatment options
is eucaliptus a treatment option for coronavirus	what are treatment options
is tamiflu effective against covid	what are treatment options
what are some treatment options for covid 19	what are treatment options
do we have a cure yet	what are treatment options
what is the best cure for covid 19	what are treatment options
how to treat covid at home	what are treatment options
is the coronavirus curable	what are treatment options
is there a cure for the virus	what are treatment options
what can i use instead	what are treatment options
does elderberry juice treat covid	what are treatment options
what does the cdc recommend to treat coronavirus	what are treatment options
natural remedies for covid 19 side effects	what are treatment options
can i use flu medicine to treat covid	what are treatment options
what can i do to cure coronavirus	what are treatment options
what are my covid treatment options	what are treatment options
how long until a vaccine	what are treatment options
what medication can i take to get over covid 19	what are treatment options
cdc covid 19 treatment recommendations	what are treatment options
can medicine cure corona	what are treatment options
will essential oils fight coronavirus	what are treatment options
the covid 19 vacciine is on the way	what are treatment options
can i use vinegar to clean my throat	what are treatment options
what can i use as a treatment for covid 19	what are treatment options
does coronavirus have a cure	what are treatment options
treatments for corona	what are treatment options
where should i go for medical advice	what are treatment options
give me treatment options for covid 19	what are treatment options
any homeopathic remedies for covid 19	what are treatment options
do nsaids treat covid 19	what are treatment options
is there a covid 19 vaccine in the works	what are treatment options
best cure for the corona virus	what are treatment options
latest treatment for sars cov 2	what are treatment options
how can i alleviate covid symptoms	what are treatment options
if i think i have covid should i go to the hospital	what are treatment options
will eating more fruit cure coronavirus	what are treatment options
is there a cure for the coronavirus	what are treatment options
what have the doctors come up with	what are treatment options
are there any treatments for covid	what are treatment options
does that lupus medicine work for covid	what are treatment options
what is the cure to covid	what are treatment options
what are some updates on the cure for covid 19	what are treatment options
are there any approved vaccines for covid 19	what are treatment options
how are covid patients treated in the hospital	what are treatment options
covid 19 cures	what are treatment options
what treatments are there for covid right now	what are treatment options
how can i get treated	what are treatment options
who offers a vaccine for corona virus	what are treatment options
best treatment for corona virus cough	what are treatment options
is there a vaccine for covid	what are treatment options
does quinine help with covid	what are treatment options
treatment against covid 19	what are treatment options
how many more months until a vaccine is ready	what are treatment options
does hydroxychloroquine treat corona	what are treatment options
can i use hydroxycholroquine for novel virus	what are treatment options
list high risk areas for covid 19	what if i visited high risk area
can i travel outside the united states right now	what if i visited high risk area
what should healthcare workers be doing	what if i visited high risk area
is there a list of protected gear i need when leaving my house	what if i visited high risk area
should i get tested after visiting a high risk area	what if i visited high risk area
how do i know if i have visited a high risk area	what if i visited high risk area
is public transportation considered a high risk area	what if i visited high risk area
i live near the beach should i be concerned	what if i visited high risk area
how do we protect ourselves from virus in family	what if i visited high risk area
what do i do if i have to visit a high risk area	what if i visited high risk area
what if i have to work in a high risk area during coronavirus outbreak	what if i visited high risk area
is munich germany also on lockdown	what if i visited high risk area
are there steps to follow for people who visited high risk areas	what if i visited high risk area
i live in a high risk area what are the chances i have contracted or am a carrier of disease	what if i visited high risk area
how do i protect myself in high risk areas	what if i visited high risk area
which essential business has the highest risk of infection	what if i visited high risk area
what qualifies as a high risk area for coronavirus	what if i visited high risk area
show me local high risk areas	what if i visited high risk area
is it safe to visit an elderly care center	what if i visited high risk area
what should my mom do since she works at the hospital	what if i visited high risk area
what shoud essential workers do to protect people in their household	what if i visited high risk area
which state has the second highest risk	what if i visited high risk area
how do i deal with someone that just came from china	what if i visited high risk area
where can i track the global outbreak	what if i visited high risk area
what are the highest risk businesses to visit right now	what if i visited high risk area
can i fly during coronavirus outbreak	what if i visited high risk area
does visiting a high risk location help spread the virus	what if i visited high risk area
what areas have the quarantine restrictions in place for covid 19	what if i visited high risk area
what protection can i use if i am in a high risk area	what if i visited high risk area
what locations are considered at high risk for coronavirus	what if i visited high risk area
which countries are safe for nonessential international travel	what if i visited high risk area
am i in a high risk area	what if i visited high risk area
which countries are most affected by coronavirus outbreak	what if i visited high risk area
is it safe to go grocery shopping	what if i visited high risk area
what is the current pandemic status in rome italy	what if i visited high risk area
am i in a high risk area for covid 19	what if i visited high risk area
which businesses are considered high risks	what if i visited high risk area
what should i bring for going into high risk areas	what if i visited high risk area
my flight from japan had someone test positive should i be worried	what if i visited high risk area
which country is currently the highest risk	what if i visited high risk area
what should i do if i have to go to the grocery store	what if i visited high risk area
i just came back from china should i get tested	what if i visited high risk area
is it ok to visit japan this year once the lockdown is over	what if i visited high risk area
are there any guidelines i can follow if i visited a high risk area	what if i visited high risk area
which cities in the united states are at most risk for coronavirus right now	what if i visited high risk area
what is the nearest high risk area to me	what if i visited high risk area
what are high risk areas for coronavirus	what if i visited high risk area
how should i self quarantine in a high risk coronavirus area	what if i visited high risk area
I have been to a lot of infected places will i get the coronavirus	what if i visited high risk area
is there a protocol to follow when i need to leave my house	what if i visited high risk area
how do i protect myself if i need to go out for essentials	what if i visited high risk area
what are the high risk areas nearby	what if i visited high risk area
should i be concerned since i just visited china	what if i visited high risk area
can i continue using public transportation during the pandemic	what if i visited high risk area
which countries are still in a nationwide shutdown	what if i visited high risk area
which states have the highest coronavirus outbreaks	what if i visited high risk area
are grocery stores considered a hisk risk area	what if i visited high risk area
will i get in trouble visiting a high risk area	what if i visited high risk area
what if i live in a high risk area	what if i visited high risk area
how do i know if i have traveled from a high risk area	what if i visited high risk area
is testing mandatory in the high risk areas	what if i visited high risk area
i went to the hospital without a mask what should i do	what if i visited high risk area
what are the steps to protect myself when entering a hisk risk area	what if i visited high risk area
can i travel to and from a high risk area for coronavirus	what if i visited high risk area
what makes a place considered high risk	what if i visited high risk area
where can i find a list of high risk countries	what if i visited high risk area
should i be scared since i was around a lot of people	what if i visited high risk area
what should i do if i visited a high risk area	what if i visited high risk area
how to protect myself in high risk areas	what if i visited high risk area
do high risk areas have their own protocol	what if i visited high risk area
what should i do if i went to china	what if i visited high risk area
what state in the united states is at the highest risk	what if i visited high risk area
what do i do if i live in a high risk area for coronavirus	what if i visited high risk area
tell me about covid 19 please	what is corona
give me an update on covid 19	what is corona
describe corona	what is corona
give me more info on the pandemic	what is corona
can you update me on any new informations for covid 19	what is corona
what should i know about covid	what is corona
more infomation about corona virus please	what is corona
more details on covid 19 please	what is corona
any other details you can recount on the corona	what is corona
I would like to encounter anymore details on corona	what is corona
what is dangerous about covid 19	what is corona
any more information that relates to the covid	what is corona
tell me what i should know about covid	what is corona
i want an update on the corona virus	what is corona
what does covid 19 stand for	what is corona
tell me about covid 19	what is corona
what other information must i learn about covid	what is corona
give me the latest rundown on covid 19	what is corona
what is covid 19	what is corona
enlighten me about the virus	what is corona
what is covid 19	what is corona
can you educate me on this virus	what is corona
please describe what covid is	what is corona
what is the lowdown on this covid	what is corona
tell me about the pandemic	what is corona
more information on coronavirus please	what is corona
give me more info on covid 19	what is corona
corona virus what is it	what is corona
what info do you have on corona	what is corona
give me the facts about covid 19	what is corona
where does the virus come from	what is corona
what is a virus	what is corona
may i have more information on covid	what is corona
tell me about the corona virus	what is corona
give me a summary on corona	what is corona
is there an outline on details regarding covid	what is corona
how did they come up with name for the virus	what is corona
what is the definition of the virus	what is corona
tell me more information on corona	what is corona
any new informations on coronavirus	what is corona
please elaborate on the corona	what is corona
how does the virus work	what is corona
what kind of guidance can you give me on covid 19	what is corona
what kind of illness is covid 19	what is corona
i want to hear about corona virus	what is corona
give me a profile on corona	what is corona
enlighten me about the virus	what is corona
is coronavirus like the flu	what is corona
is coronavirus dangerous	what is corona
any description on the corona	what is corona
please give more info on covid 19	what is corona
i want to know about the virus	what is corona
educate me about corona	what is corona
what is coronavirus	what is corona
what intelligence do you have on the virus	what is corona
can i get a report on what is the corona	what is corona
can you tell me what corona virus is	what is corona
tell me about corona virus	what is corona
where did the covid 19 come from	what is corona
more details that relate to corona virus	what is corona
give me an update on the pandemic	what is corona
can you give me advice about covid 19	what is corona
tldr of coronavirus	what is corona
what information can you give me	what is corona
what is the inside story about the virus	what is corona
what else can i learn about the corona virus	what is corona
please more information regarding the corona virus	what is corona
is there more details about the corona virus	what is corona
tell me about corona virus	what is corona
i want to hear more about the pandemic	what is corona
can you give me a understanding of covid	what is corona
educate me on covid 19	what is corona
give me a general update on the corona virus	what is corona
would there be anymore details about covid	what is corona
care to explain explicit details on corona	what is corona
brief me about the corona	what is corona
what is the narrative on the virus	what is corona
is the virus present in dog saliva	can i get from feces animal pets
can pets spread covid 19	can i get from feces animal pets
can my dog get the virus	can i get from feces animal pets
how does the virus affect animals	can i get from feces animal pets
what should i do if i think my animal has the new strain of coronavirus	can i get from feces animal pets
give me information about the virus and animals	can i get from feces animal pets
do cat scratches contain the virus	can i get from feces animal pets
does corona virus transmit from pets to humans	can i get from feces animal pets
can i get covid 19 from mice	can i get from feces animal pets
are baby animals affected more	can i get from feces animal pets
how do i avoid getting covid from animals	can i get from feces animal pets
should i have contact with my pet if i have the coronavirus disease	can i get from feces animal pets
is there any evidence that pets other than dogs and cats could be susceptible	can i get from feces animal pets
can pets spread covid19	can i get from feces animal pets
has any animals tested positive from corona	can i get from feces animal pets
what types of animals can spread the virus	can i get from feces animal pets
can humans contract coronavirus from an aimal	can i get from feces animal pets
are my birds at risk to catch the virus	can i get from feces animal pets
do i need to worry about my pets during the virus	can i get from feces animal pets
is the coronavirus disease zoonotic	can i get from feces animal pets
can i get corona virus from eating sushi	can i get from feces animal pets
can houseflies spread covid 19	can i get from feces animal pets
how can i tell if my pet get sick from coronavirus	can i get from feces animal pets
what about the sneeze of a tiger	can i get from feces animal pets
can a pets fur spread the virus that causes covid 19	can i get from feces animal pets
can we get sick from giraffe mucus exposure	can i get from feces animal pets
can i get corona virus from eating beef	can i get from feces animal pets
do raccoons carry covid	can i get from feces animal pets
should my pet wear a face mask when in public	can i get from feces animal pets
what animals carry corona	can i get from feces animal pets
should i be worried about my pets catching covid 19	can i get from feces animal pets
can chicken breasts contain the rona	can i get from feces animal pets
who will collect the samples from my pets if my pets have covid 19 symptoms	can i get from feces animal pets
are there any species of amphibians that carry covid	can i get from feces animal pets
can pets get the coronavirus and can we catch it from them	can i get from feces animal pets
should i quarantine my cat too	can i get from feces animal pets
how can i tell my cat does not have covid 19	can i get from feces animal pets
can the blood of an infected animal spread the virus to my kids	can i get from feces animal pets
how many types of marsupials have been infected	can i get from feces animal pets
can insects be coronavirus carriers	can i get from feces animal pets
can i get the virus from deer meat	can i get from feces animal pets
can i get it from animals	can i get from feces animal pets
can animals carry the coronavirus	can i get from feces animal pets
i am helping someone who is sick by walking their dog how do i stay safe	can i get from feces animal pets
can the virus spread through feces	can i get from feces animal pets
can my daughter get the virus from my pet	can i get from feces animal pets
how can i tell if my cat has corona	can i get from feces animal pets
can i get the virus from dogs	can i get from feces animal pets
do i need to worry about wild life like birds squirrels can them spread virus too	can i get from feces animal pets
how safe are cat bites during the pandemic	can i get from feces animal pets
should i stop eating meat	can i get from feces animal pets
if a dog bites me can i get covid 19	can i get from feces animal pets
could the coronavirus mutate over time into strains for dogs or cats	can i get from feces animal pets
do mosquitos carry covid	can i get from feces animal pets
does the virus transmit via pets	can i get from feces animal pets
is there a limit to how many animals can be treated for the rona	can i get from feces animal pets
can a dog contract the virus	can i get from feces animal pets
can a bird test positive	can i get from feces animal pets
can i get the virus from eating pork	can i get from feces animal pets
can mosquitoes spread coronavirus	can i get from feces animal pets
should pets be tested for coronavirus	can i get from feces animal pets
can a bears sneeze spread coronavirus	can i get from feces animal pets
can my pets catch covid19	can i get from feces animal pets
how does corona effect my pets	can i get from feces animal pets
should i worry about petting animals and getting the virus	can i get from feces animal pets
can i get covid 19 from petting a cat	can i get from feces animal pets
are sea animals contracting the virus	can i get from feces animal pets
what is the treatment for covid 19 on pets	can i get from feces animal pets
can a dead skunk on the road get a hungry coyote ill	can i get from feces animal pets
can i get corona virus from mosquitos	can i get from feces animal pets
why coronavirus affects some animals but not others	can i get from feces animal pets
does bird feces contain the virus	can i get from feces animal pets
should i eat uncooked meat like sushi without coronavirus concern	can i get from feces animal pets
does covid 19 stay on gaming systems	can i get from packages surfaces
have people got covid from deliveries from china	can i get from packages surfaces
do i need to clean my mailbox	can i get from packages surfaces
can covid19 live on bags from the store	can i get from packages surfaces
does covid 19 stay on furniture	can i get from packages surfaces
should i stop getting deliveries	can i get from packages surfaces
should i clean delivery packages beforehand	can i get from packages surfaces
is covid good at living on steel	can i get from packages surfaces
will covid 19 stick to my gloves	can i get from packages surfaces
what surfaces are safest	can i get from packages surfaces
what is best way to clean any surface carrying virus	can i get from packages surfaces
how long does covid19 stay on public surfaces	can i get from packages surfaces
what is the most dangerous material	can i get from packages surfaces
can alcohol kill the virus	can i get from packages surfaces
is it safe to lick envelopes	can i get from packages surfaces
how fast does coronavirus die on surfaces that are cleaned	can i get from packages surfaces
does covid 19 attach onto fruit	can i get from packages surfaces
which surface is most likely to have virus for the longest time	can i get from packages surfaces
how long coronavirus stay on surfaces	can i get from packages surfaces
is it safe to get food delivered	can i get from packages surfaces
can coronavirus get on door handles	can i get from packages surfaces
am i safe to handle plastic things	can i get from packages surfaces
do you need to dilute bleach to clean	can i get from packages surfaces
should i be using public hand rails without gloves	can i get from packages surfaces
will i get the covid from pumping gas	can i get from packages surfaces
can covid19 stay on handle bars	can i get from packages surfaces
how does the virus survive on different surfaces	can i get from packages surfaces
can the virus live on wood items	can i get from packages surfaces
while staying on surfaces does covid become stronger	can i get from packages surfaces
does covid 19 live long on cardboard	can i get from packages surfaces
can i get the virus from using plastic bags from safeway	can i get from packages surfaces
does it stay active on surfaces	can i get from packages surfaces
does hand santizer kill the virus on packages	can i get from packages surfaces
should i wash all my shopping	can i get from packages surfaces
does covid 19 go away after some time	can i get from packages surfaces
how effective is cleaning with alcohol	can i get from packages surfaces
does covid 19 attach itself to the walls	can i get from packages surfaces
should i use one specific type of material	can i get from packages surfaces
is plastic a carrier of covid 19	can i get from packages surfaces
will i get infected if i touch something a patient has used	can i get from packages surfaces
does covid 19 have a surface it can not attach to	can i get from packages surfaces
can the virus spread on my tv remote	can i get from packages surfaces
does covid 19 seep into the walls	can i get from packages surfaces
can covid 19 live on car surfaces	can i get from packages surfaces
does covid 19 stay on ceilings	can i get from packages surfaces
can you get coronavirus from borrowing clothes	can i get from packages surfaces
what is the amount of time the corona virus stays on surfaces	can i get from packages surfaces
can amazon packages transmit the virus	can i get from packages surfaces
can electonic surfaces contain covid19	can i get from packages surfaces
is there type of material it can not live on	can i get from packages surfaces
which bag to use for groceries	can i get from packages surfaces
how to clean delivery packages	can i get from packages surfaces
are there surfaces covid 19 can not live on	can i get from packages surfaces
how long is covid 19 active on surfaces	can i get from packages surfaces
what is the timeframe for covid19 to remain active on surfaces	can i get from packages surfaces
can you get sick by touching a surface with virus	can i get from packages surfaces
is it safe to use glassware	can i get from packages surfaces
can you get covid from opening a trash can	can i get from packages surfaces
does covid 19 stay on books	can i get from packages surfaces
is touching hand rails safe	can i get from packages surfaces
how often should i clean my table	can i get from packages surfaces
can the virus live on my phone	can i get from packages surfaces
how long does it stay on a surface that is not touched	can i get from packages surfaces
what is the worst thing to touch	can i get from packages surfaces
can coronavirus live on the exterior of my face mask	can i get from packages surfaces
can coronavirus get on my toilet paper	can i get from packages surfaces
does covid 19 have specific surfaces it can not be removed from	can i get from packages surfaces
is it safe to handle envleopes	can i get from packages surfaces
can i get covid19 from mail deliveries	can i get from packages surfaces
what is the best material covid 19 dies on	can i get from packages surfaces
does covid get weaker if stays too long on the surfaces	can i get from packages surfaces
are fruits and vegetables susceptible carriers of virus	can i get from packages surfaces
is vinegar effective in cleaning plastics	can i get from packages surfaces
